NO ./rsrcs/textures/N.xpm
SO ./rsrcs/textures/S.xpm
WE ./rsrcs/textures/W.xpm
EA ./rsrcs/textures/E.xpm
F 220,100,0
F 0,0,0
C 225,30,0

11111
1N001
11111