C 225,30,0
NO ./rsrcs/textures/N.xpm
WE ./rsrcs/textures/W.xpm
EA ./rsrcs/textures/E.xpm
F 220,100,0
SO ./rsrcs/textures/S.xpm

1111111
1000001
10N0001

1000001
1111111